111111111111111111111111
150000000000000000000001
111111110111111111002201
111111000000000000000001
111111100011111111111111
140000000000000000000411
111111111111111111111111