1111111111111
1004000400041
1000000000201
1000200000501
1000200000001
1010000000001
1111111111111