1111111111111
1001000000001
1000000502201
1000001000001
1011111111101
1411111111141
1111111111111