111111111111111111111111
111111111111411111111111
111111111111011111111111
111111111111011111111111
111111111000000011111111
111111111002020011111111
111111111000500011111111
140000000002020000000041
111111111000000011111111
111111111111011111111111
111111111111011111111111
111111111111011111111111
111111111114011111111111
111111111111111111111111