1111111111111
1001000000401
1000000000201
1000200000501
1000200000001
1111111111111
1111111111111
1111111111111
1111111111111
1111111111111
1111111111111
1111111111111