111111111111111111111111
100111111111000000000001
100200000050020000020001
100110000001111101111111
100000002001000000000041
100011111111000000000041
100000000000000000100041
100000000000000000100041
111111111111111111111111