1111111111111
1001000000401
1000000500201
1044444444401
1000200000001
1010000000001
1111111111111