111111111111111111111111
100000000040100000000001
100111111111002000000201
100020000050000000000001
100020000001111111111111
100000000001000400000001
100000011111000000040001
100000000000000000000001
100000000000000000000401
111111111111111111111111