1111111111111
1001000000001
1000000000201
1000200000501
1040200040001
1010000000001
1111111111111